**XXXXXXXXXXXXXXXXXXXXXXXXXXXXXXXXXXXXXXXXXXXXXXXXXXXXXXXXXXXXXXXXXXXXXXXXXXXXXXXXX***XXXXXXXXXXXXXXXXXXXXXXXXXXXXXXXXXXXXXXXXXXXXXXXXXXXXXXXXXXXXXXXXXXXXXXXXXXXXXXXXXXXXXXXXXXXXXXXXXXXXXXXX
X*X*X*X*X*XX*XX*X*XXXXXXXXX*X*XXX*X*X*X*X*X*XX*X*XXXX*X*XX*X*X*XXX*XXXX*X*XXXXX*X*X*X*XX*X*XXX*XXXXXX*X*XX*X*X*XXX*X*X*X*X*X*XXXX*X*X*XXXXX*X*XX*X*XXX*XXXX*X*XX*X*X*XXX*X*XX*XXXX*XX*X*XXXXX*
**X*X*X*X*X**X**X*X*********X*X***X*X*X*X*X*X**X*X****X*X**X*X*X***X****X*******X***X****X*X***X******X*X**X*X*X***X*X*X*X*X*X****X*X*X*****X*X**X*X***X****X*X**X*X*X***X*X**X****X**X*X*****
*X*X*XX*X*X*XX*X*XXX*XXXXX*X*XX*XX*X*X*XX*X*XX*XX*XXXX*X*X*XXXXXX*XX*X*X***XX******XX***X*X*XX*X*X*X*X*XX*XXX*XXXXX*X*X*X*X*XXXX*X*XX*X*X*XXX*XX*XX*XX*XXX*XX*XXX*X*X*XXXX*XXXXXXX*X*XX*XXX*X*
*X*X*X**X*X*X**X*X***X*****X*X**X**X*X*X**X*X**X**X****X*X*X******X**X*****X**X*********X*X*X**X*X*X*X*X**X***X*****X*X*X*X*X****X*X**X*X*X***X**X**X**X***X**X***X*X*X****X*******X*X**X***X*
**XXXX*XX*X*XXXX*XX*X*X*X*X*XX*X*XXXXXX*X*X*XX*XXX*XX*XX*X*XX*X******X**X*X*X*XX*XX*XX*X*X*XXX*XX*XX*X*X*XXX*XXX*XX*XXXXXX*X*XXX*XXXX*XXXXXXX*X*XXX*X*XX*XXX*XX*X*XX*XXX*XX*X*XXXXXXXXX*XXX*XX
**X****X**X*X****X**X*X*X*X*X**X*X******X*X*X**X***X**X**X*X**X******X****X*X*X**X*******X*X***X**X**X*X*X***X***X**X******X*X***X****X*******X*X***X*X**X***X**X*X**X***X**X*X*********X***X*
*XXX*XXXXX*X*X*XXX*X*XX****XX*X*X*XX*XXX*X*XX*X*XXX*XXX*XX*XXX***XX*XX*X**XX*X********XX*XXX*X*X*X*XX*X*X*X*XXX*XXXX*X*X*XXX*XX*X*X*XXX*X*XXX*X*X*XX*XX*XX*XX*X*XX*X*XXXXX*X*XXXX*XXX*XXX*X*X*
*X***X*****X*X*X***X*X********X*X*X**X***X*X**X*X***X***X**X***X*X********X******X****X**X***X*X*X*X**X*X*X*X***X****X*X*X***X**X*X*X***X*X***X*X*X**X**X**X**X*X**X*X*****X*X****X***X***X*X*
**XXX*X*X*X*XXX*X*X*X*X**X***XXX*XX*XXXXXX*X*X*******X*X*X*XX***XX**X***X*X***X*X***XX*XX*X*XXXXXXXX*XX*XXXXXXX*XX*X*X*XXXX*XXXXX*X*XXX*XXXXX*XX*XXX*XX*XX*X*X*XXX*X*XX*X*XX*X*XX*X*XXXXXXX*XX
******X*X*X*X***X*X*X*X**X***X***X**X******X*X***X***X*X*X*X**X*X***X*X*****X*X***X*X**X*************X**X*******X**X*X*X****X*****X*X***X*****X**X***X**X**X*X*X***X*X**X*X**X*X**X*X*******X*
X*X*X*X*XX*XX*XX*X*XXX*X*****XXX*X*X*X*XX*X*XXX****X*X*XXX*X**X*X*X****X*X*X****XXX*XX*X***X*XXX*XXX*XXXX*X*X*XX*X*XXX*XXXX*XX*X*XX*XX*XXX*XX*X*XXXXXX*X*XX*XX*X*XXXX*X*X*X*XXX*X*XXXXX*XXX*X*
**X*X*X*X**X**X**X*X***X*****X***X*X*X*X**X*X***X******X******X*X*X**X*X*X****X*****X********X***X***X****X*X*X**X*X***X****X**X*X**X**X***X**X*X******X*X**X**X*X****X*X*X*X***X*X*****X***X*
X*X*X*XX*X*X*X*XX*XXX*X*X*X*X*XXX*XXX*X*XX*X*X*XX**X****X*X*XX*XXXX*X*X*X**X*X*XXXX*****XX**X*X*X*X*XX*XX*X*XX*X*X*X*X*XXXXX*XXX*XX*XX*X*X*X*X*XXXX*XXX*XX*X*X*XXXX*X*XXX*XXXX*XX*XX*XX*XX*X*X
**X*X*X**X*X*X*X**X***X*X*X***X***X***X*X**X*X****X*********X**X****X*X*X*X****X*****X*X****X*X*X*X*X**X**X*X**X*X*X*X*X*****X***X**X**X*X*X*X*X****X***X**X*X*X****X*X***X****X**X**X**X**X*X
XX**XX*X*X*XXX*X*XX*XX****XX*X*XX*XXXX*X*XX******XX*XX*X*XX*XXXXX*X*XX*XX***X*XX*X*X*******X*XXX*XX*X*XX*XX*X*XX*XX*XXX*XX*XX*X*XXXXX*XX*XXX*X*XX*X*XXX*X*X*X*XX*X*XX*XXX*XX*XXX*X*X*XX*XX*X*X
****X**X*X*X***X*X**X***X*X*******X****X*X*******X**X**X*X**X*****X*X**X**X***X**X***********X***X**X*X**X**X*X**X**X***X**X**X*X*****X**X***X*X**X*X***X*X*X*X**X*X**X***X**X***X*X*X**X**X*X
**X****XXXX*XXXX*X*XX*X******XXX***X*XX****X*XXX*X*X*X*X*XXX*XXX*X*X*XXXXX*XXX*XX***XX*XXXXX*X*XXXXXXXX*X*X*XX*X*XX*XXX*XX*X*XXXXXXXX*X*X*X*X*X*X*X*X*X*XXXXX*X*XXX*X*XX*XX*XXX*XXX*XX*XX*XX*X
****X**X****X****X*X**X***X********X*X***X*X*X***X*X*X*X*X***X***X*X*X*****X********X**X*****X*X********X*X*X**X*X**X***X**X*X********X*X*X*X*X*X*******X*****X*X***X*X**X**X***X***X**X**X**X
**X**X***XXXX*XXX*X*X*******X*XXX**X*X****X*XX*XXXX*XXX*XXXX*X*X*X*X*X*X*XXX*XXXX*XX*XXXXX*XXX*XX*XX*X*XX*XX*X*XXXX*XXXX*X*XXX*XXX*XX*XX*X*XX*X***XXXX*X*XX*X*XXX*XX*XX*X*X*X*X*XX*XX*XXX*X*XX
**X***********X***X*X***X***X*X***X**X*X****X**X****X***X****X*X*X*X*X*X*X********X**X*****X***X**X**X*X**X**X*X****X****X*X***X***X**X**X*X**X********X*X**X*X***X**X**X*X*X*X*X**X**X***X*X*
*XX**XX*X**X*X*XX*X*X*X*********X*XX*X*X*******XX*X*XXX*X*XXX*X*XXX*XXX*XX*X*X*X****X*X*XX*X*XXX*X*XX*X*X*X*X*XXX*XXXXX*X*XXXXXXX*X*XXXX*XXXXXX***X***XXXXX*XX*XX*X*XXX*XXX*X*XX*X*X*X*XX*X*XX
*****X**X**X*X*X**X*X*X******X*X**X**X*X*X**********X***X*X***X*X***X***X**X*X*X*X**X*X*X**X*X***X*X**X*X*X*X*X***X*****X*X*******X*X****X********X***X*****X**X**X*X***X***X*X**X*X*X*X**X*X*
*X*XX*XXX*X*X*******X*X*X*X***X***X*X*XXX*X*XX*XX*X***XXX*X*X*X*X*XXX*X*XXX*XXX*XX**XX*X*XX*XXXXXX*X*XXXX*X*XX*XX*X*XX*XXX*X*XXX*X*X*XX*X*X*X*X*X*X**XXX*X*XX*X*X*X*XXX*X*X*X*XXX*XXXX*XX*XX*X
***X********X*******X*X*X***X*******X*X***X*X**X**X***X***X*X*X*X*X***X*X***X***X******X*X**X******X*X****X*X**X**X*X**X***X*X***X*X*X**X*X*X*X*X********X*X**X*X*X*X***X*X*X*X***X****X**X**X
*X**X***X*X*XX**X*X***XX*X***XXXX**XXX*XXX*XXX*X*X****X*X*XXX*X*X*XXX*X*X*X*XXXX*X*XXXX*XX*XX*X*XX*X*XX*X*XXXX*XXXX*XXX*XXXXXXXX*XX*XXXX*X*XXX*X*X***X**XX*XX*XXX*XXX*XXX*X*X*XX*XXX*XXXXXX*X*
*X****X*X*X*X**************X*X*****X***X***X***X*X****X*X*X***X*X*X***X*X*X*X****X******X**X**X*X**X*X**X*X****X****X***X********X**X****X*X***X*X***X*****X******X***X***X*X*X**X***X******X*
*XXX*X*XXXX*X*XX*X**X*X*X**X**X*X*XXXX*XX*X*XXX*X***X*X*X*XXX*XXXXXX*X*XXXXXX*X*XX*XX**X*X*X*XXXX*XXXXX*XX*X*XX*X*X*X*X*X*X*X*XXX*XXXX*X*X*XX*X*XX*X*XX***X***X***XXXX*X*X*XXX*X*XX*X*XXX*X*XX
*****X*X****X*X**X************X***X****X**X*X***X*X*X*X*X*X***X******X*X******X*X**X*****X*X*X****X*****X**X*X**X*X*X*X*X*X*X*X***X****X*X*X**X*X**X*X**X*********X****X*X*X*****X**X*X***X*X*
*X*X*XX*XXX*X*X*X*XX*X*X*X*X*XX***X*X*XX*X*X*XXX**X*XXX*XXX*X*XXXXX*XX*X*X*XX*XX*X*XXXX***XXXXX*X*XXX*X*X*XX*X*X*X*XX*XX*XX*XXXX*XXX*XX*X*XXXX*X*XX**X*XXX*****X*XXXXX*XX*XX**X****XX*X*XX*XX*
***X*X**X***X*X*X*X**X*X***X*X**X*X*X*X**X*X*X***X**X***X***X*X*****X**X*X*X**X**X*X******X*****X*X***X*X*X**X*X*X*X**X**X**X****X***X**X*X****X*X*****X*********X*****X**X********X**X*X**X**
*X*X*X*X*X*X*XX*X*X*X*XX**X*XX*X**XXX*XXXX*XX****X*X*XXX*X*X*X*XX*X*XX*XXXXX*XXX*XXX*XXX*XXX*X*X*XX*X*X*XXX*X*X*XX*XXX*X*X*XX*X*X*X*X*X*X*XXX*XX*XX***X*XX***X*XXXX*XXXX*X*XXX*XX*************
*X*X*X*X*X*X*X**X*X*X*X*****X**X******X****X**X**X*X*X***X*X*X*X**X*X**X*****X***X***X***X***X*X*X**X*X*X***X*X*X**X***X*X*X**X*X*X*X*X*X*X***X**X**X*X*X**X*X******X******X******X***********
***X*XX*XXXXXXXXXX***XX****X*XX**XX*XX*X*X***XXX*XXX*XXXXXX*X*XX*XX*X*X*X*X*X*X*X*XX*XX*****X*X*X*XX*X*XX*X*XXX*X*X*XXX*X*X*XXXX*X*XX*X*XXXX*X*X*XX*X*XX*XX***X**XX*X***X***X*X*X*X***X*XX*X**
***X*X**X**********X*******X*X******X**X*X*******X***X******X*X**X**X*X*X*X*X*X*X*X**X**X*****X*X*X**X*X**X*X***X*X*X***X*X*X****X*X**X*X****X*X*X****X**X**********X***X***********X*X*X****X
*X*XXX*XX*X*XXX*X**XXXX*X*X*X**XXX*XX*X*X**XX*X*X*XX*XXXX*XXXXXXXXXX*X*XXX*XXXXX*XX*X*X*XX*X***X*XXX*XXX*XX*XXX*XXX*XXXX*XXX*X*XXX*XX*XX*XX*X*XXXX*XX**X***XX**XX***X**X*X***X*XXXXX*XXX*X**X*
*X*X***X**X*X***********X*X****X***X**X*X**X**X*X*X**X****X**********X*X***X*****X**X*X*X**X***X*X***X***X**X***X***X****X***X*X***X**X**X**X*X****X*******X******X***X**X**X**X*********X****
X**XXXX*XX*XX*X***XX*XX*X****XXX*XXX*X****XX*XX*X*X*XX*X*X*X*XXXX*X*XXXX*XX*X*XXX*XXXXXXX*XX**X*XXX*X*X*X*XX*XX*X*XX*XXXXXX*X*X*X*XX*X*XXX*XX*X*XX*XXXX*XX*XX*X****X*X*X*****XX*XX***X*XX**XXX
***X****X**X**X***X**X*******X***X***X***X***X**X*X*X**X*X*X*X****X*X****X**X*X***X*******X*****X***X*X*X*X**X**X*X**X******X*X*X*X**X*X***X**X*X**X****X**X**X*X**X*********X**X****X****X***
***XX*X*XX*XXX***XX*X*X*XX****X*XX*****X*XX*X*XX*XX*XX*X*X*X*XXXXXX*X*XX*X*X*XXX*XX*XXXXX*X*X*X**XXXX*XX*X*XX*X*X*XXX*X*XXXXX*XX*X*XX*X*XXXXX*XX*X*XX*X*X*X*XX*XX***X*XX*X**XXX*X*X***X*X*X***
*X*X**X*X**X********X*X*********X****X*X*X**X*X**X**X**X*X*X*X******X*X**X*X*X***X**X*****X******X****X**X*X**X*X*X***X*X*****X**X*X**X*X*****X**X*X**X*X*X****X**X***X**X******X*X***X*X***X*
*XX*XX*XXXX*X***XXXX*XX*****X**X*X*X*X*X*XXXXX*X*XXX*X*X*X*X*XX*XXX*XX*X*XX*X*X*X*XXXX*X*XX***XX*X*XX*XX*XXXX*X*X*X*XX*X*XX*XX*XX*X*X*X*X*XX*XXXX*X*XX*X*XX*****X***X*X*X*X**X*XX*XX*XX*XX*X**
****X**X****X***X****X****X********X*X*X*X*****X*X***X*X*X*X*X**X***X**X*X**X*X*X*X****X*X*******X*X**X**X****X*X*X*X**X*X**X**X**X*X*X*X*X**X****X*X**X*X****X****X**X*X*X*******X**X**X*****
X*X*X*X*X*X*X**X*X*X*X*X*XXX**X****X*X*XX*XX*XX*XXX*XXXXX*X*X*X*X*XXXXXXXX*XXXXX*X*X*XXX*X*XXXX****X*XX*XX*XX*X*XX*X*XX*XXX*XXXX*XXX*X*XX*X*X*X*XX*XX****XX*X*XX***X*X*XX*XX****X****XX*******
****X*X*X***X****X*X*X*X*X****X****X*X*X**X**X**X***X*****X*X*X*X*X********X*****X*X*X***X*X*********X**X**X**X****X*X**X***X****X***X*X**X*X*X*X**X********X*X****X*X*X**X*************X*X***
XX*X*XXX**X**XX**XXX*X*XXX**XXXX*XX*XX*X*XX*XX*X*XXX*X*X*X*X*XXX*XX*X*XXXXXXXX*XX*X*X*XX*XX*X*X*X****XXXXXXX*XXX*X*XXXXXXX*X*X*XX*X*X*XXXX*X*X*X*X*X****XXX*X*****X*X*XXXXX**X**X*XX*X*XX*X*X*
***X*X***************X*X*********X**X**X*X**X**X*X***X*X*X*X*X***X**X*X********X**X*X*X**X**X*X*X*X**********X*************X*X****X*X*X****X*X*X*X******X***X***X*X*X*X********X*****X****X*X*
**XX*X***X*X***XX**XXX*X***XXX*XXX*X*XXXX*XX*X*X*XXX*XX*X*XXX*XXX*XX*XXX*XX*X*XXXXX*X*X*X*XXX*X*X*XX*********XX**X*X*****X*XX*****X*XX*XXX****X*X****X*XXXXX*X***X*X*****X**X*X***X***X***X*X*
*****X***X*X*X*X***********X***X***X*X****X**X*X*X***X**X*X***X***X**X***X**X*X*****X*X*X*X***X*X*X**X****X**X**X******X***X**X*****X***********X****X*X*****X*****X*******X**X*X*X*X*X***X***
***X****XXXXXX*****XXXXXXXXXXXXXXXXXXXXXXXXXXXXXXXXXXXXXXXXXXXXXXXXXXXXXXXXXXXXXXXXXXXXXXXXXXXXXXXXXXXXXXXX****XXX***XXXX*****XXX*****XXXXXXXXX****XXXXXXXXXXXXXXX***XXX***XX***XXXXX****XXXX*
