****************************************************************************************************
*X*XXXXX*XXXXX*X*X*XXXXX*X*X*XXXXX*X*X*X*XXX*X*X*X*XXXXX*X*X*XXXXX*XXX*XXXXXXX*X*XXX*XXX*XXX*X*X*XX*
*X*X*****X*****X*X*X*****X*X*X*****X*X*X*X***X*X*X*X*****X*X*X*****X***X*******X*X***X***X***X*X*X**
XX*XXX*XXX*X*XXXXXXX*XXXXX*XXX*X*XXX*XXXXX*X*XXXXX*X*XXXXXXXXXXX*XXX*X*X*X*X*X*X*XXX*XXX*X*X*XXXXX*X
***X***X***X*X*******X*****X***X*X***X*****X*X*****X*X***********X***X*X*X*X*X*X*X***X***X*X*X*****X
XXXXXX*XXX*XXXXX*XXXXX*XXX*XXXXXXX*X*X*X*XXX*XXXXX*XXXXX*XXX*XXXXX*X*XXXXXXXXX*XXXXX*X*X*X*X*X*XXX*X
*******X***X*****X*****X***X*******X*X*X*X***X*****X*****X***X*****X*X*********X*****X*X*X*X*X*X****
XXXXXX*X*XXX*XXXXXXXXXXX*XXXXXXXXX*X*XXX*XXX*X*X*XXXXXXXXX*X*X*X*X*XXXXX*X*XXX*X*X*X*XXX*XXXXX*X*X*X
*******X*X***X***********X*********X*X***X***X*X*X*********X*X*X*X*X*****X*X***X*X*X*X***X*****X*X**
XXXX*X*XXX*XXXXXXX*X*X*XXX*X*XXXXXXXXXXX*X*X*X*XXX*XXX*XXXXX*X*XXXXXXXXX*XXXXX*X*XXXXX*X*X*X*X*X*X*X
*****X*X***X*******X*X*X***X*X***********X*X*X*X***X***X*****X*X*********X*****X*X*****X*X*X*X*X*X**
XX*X*XXXXXXXXX*X*XXXXXXXXXXXXX*XXX*X*X*XXX*XXXXXXX*X*XXX*X*X*X*X*XXX*X*X*X*XXXXX*X*XXXXX*XXX*X*X*X*X
***X*X*********X*X*************X***X*X*X***X*******X*X***X*X*X*X*X***X*X*X*X*****X*X*****X***X*X*X**
XXXX*XXXXXXX*XXX*X*XXX*XXXXXXX*X*XXX*X*X*XXX*X*XXXXXXX*X*X*XXX*X*X*X*X*XXX*XXX*XXXXXXXXXXX*X*XXX*X*X
*****X*******X***X*X***X*******X*X***X*X*X***X*X*******X*X*X***X*X*X*X*X***X***X***********X*X***X**
XX*X*XXX*X*XXXXXXX*X*XXXXXXX*XXXXXXXXXXXXXXXXXXXXX*X*XXXXXXXXX*X*X*X*XXXXX*XXXXX*X*XXX*XXXXX*XXXXX*X
***X*X***X*X*******X*X*******X*********************X*X*********X*X*X*X*****X*****X*X***X*****X*****X
XX*X*X*X*XXXXX*XXX*X*XXXXXXX*X*XXX*XXXXXXX*XXXXX*XXXXXXXXX*XXX*XXX*XXX*X*XXXXXXX*X*XXX*X*XXXXX*X*X*X
***X*X*X*X*****X***X*X*******X*X***X*******X*****X*********X***X***X***X*X*******X*X***X*X*****X*X*X
XX*XXXXXXX*XXXXXXXXX*XXX*X*X*X*X*X*XXX*X*X*X*X*X*XXX*X*XXX*XXXXXXX*XXXXXXXXX*XXXXXXXXXXXXXXX*X*X*X*X
***X*******X*********X***X*X*X*X*X*X***X*X*X*X*X*X***X*X***X*******X*********X***************X*X*X*X
XXXX*X*X*XXXXX*X*XXXXXXXXXXX*XXX*X*XXXXXXXXXXXXXXXXXXXXX*X*X*XXX*XXX*X*XXX*XXXXX*XXXXX*XXX*X*X*XXX*X
*****X*X*X*****X*X***********X***X*X*********************X*X*X***X***X*X***X*****X*****X***X*X*X***X
*XXXXXXX*XXXXX*XXXXX*XXXXXXXXX*X*X*X*X*X*XXX*X*XXXXXXX*X*XXX*X*X*X*X*XXX*X*X*XXX*XXXXX*X*XXX*XXX*X*X
*X*******X*****X*****X*********X*X*X*X*X*X***X*X*******X*X***X*X*X*X*X***X*X*X***X*****X*X***X***X**
*XXX*X*XXX*XXX*XXX*XXX*X*X*XXXXX*XXX*X*X*XXXXXXXXX*XXXXXXX*XXX*X*X*X*X*XXX*XXXXXXXXX*X*XXXXX*X*XXX*X
*X***X*X***X***X***X***X*X*X*****X***X*X*X*********X*******X***X*X*X*X*X***X*********X*X*****X*X****
*XXX*XXX*XXXXX*XXX*X*XXX*X*X*XXX*XXX*XXXXX*X*X*X*X*XXX*X*X*XXX*X*X*X*XXX*X*XXXXX*X*XXXXXXX*XXXXX*X*X
*X***X***X*****X***X*X***X*X*X***X***X*****X*X*X*X*X***X*X*X***X*X*X*X***X*X*****X*X*******X*****X*X
XX*X*X*XXXXX*XXX*XXX*X*X*X*XXXXX*XXXXX*XXX*X*XXX*X*X*X*X*XXX*X*X*XXX*X*XXXXX*XXXXX*X*XXXXXXXXX*X*XXX
***X*X*X*****X***X***X*X*X*X*****X*****X***X*X***X*X*X*X*X***X*X*X***X*X*****X*****X*X*********X****
XX*XXXXXXX*X*XXX*X*X*XXXXX*X*X*X*X*XXX*XXX*X*XXX*X*XXX*X*X*XXX*XXXXX*X*X*XXX*XXX*XXX*X*X*XXXXXXXX*XX
***X*******X*X***X*X*X*****X*X*X*X*X***X***X*X***X*X***X*X*X***X*****X*X*X***X***X***X*X*X**********
XXXX*XXX*XXXXXXX*X*XXXXXXXXX*X*XXX*XXXXXXXXX*X*X*XXX*X*XXX*X*XXX*XXXXX*XXXXX*X*XXXXX*XXXXXXX*XXX*X*X
*****X***X*******X*X*********X*X***X*********X*X*X***X*X***X*X***X*****X*****X*X*****X*******X***X*X
*X*X*XXXXXXXXX*X*XXX*X*XXXXX*XXX*XXX*X*X*X*X*X*X*X*X*XXXXX*X*X*XXXXX*X*XXXXXXX*XXX*XXX*XXXXX*X*XXX*X
*X*X*X*********X*X***X*X*****X***X***X*X*X*X*X*X*X*X*X*****X*X*X*****X*X*******X***X***X*****X*X****
*X*XXXXX*XXXXX*X*X*XXX*X*X*XXX*X*X*X*XXXXX*X*XXX*XXXXX*X*XXX*XXXXX*X*X*X*X*XXXXX*XXXXXXX*XXXXX*X*X*X
*X*X*****X*****X*X*X***X*X*X***X*X*X*X*****X*X***X*****X*X***X*****X*X*X*X*X*****X*******X*****X*X*X
*XXXXXXXXXXXXXXX*X*X*XXXXX*XXX*XXX*XXXXXXX*XXXXXXX*XXXXXXXXX*X*XXX*X*XXX*XXX*X*X*XXX*X*X*X*XXX*X*X*X
*X***************X*X*X*****X***X***X*******X*******X*********X*X***X*X***X***X*X*X***X*X*X*X***X*X*X
*X*XXX*X*XXXXX*XXX*X*X*XXX*X*XXXXXXXXX*X*X*X*X*X*XXXXX*X*X*XXXXXXX*X*X*X*X*X*XXXXXXX*X*XXXXX*XXX*X*X
*X*X***X*X*****X***X*X*X***X*X*********X*X*X*X*X*X*****X*X*X*******X*X*X*X*X*X*******X*X*****X***X*X
*XXXXXXX*X*XXXXX*X*X*X*X*XXXXXXX*XXX*XXXXXXX*X*X*X*XXXXX*X*X*XXX*X*XXX*X*XXX*XXX*XXX*XXXXXXXXXXXXX*X
*X*******X*X*****X*X*X*X*X*******X***X*******X*X*X*X*****X*X*X***X*X***X*X***X***X***X*************X
XXXX*X*X*XXXXX*XXX*XXX*X*XXX*X*X*XXX*XXXXXXXXX*XXX*X*XXX*X*XXX*X*X*X*X*XXX*XXXXX*X*XXXXX*X*XXXXX*X*X
*****X*X*X*****X***X***X*X***X*X*X***X*********X***X*X***X*X***X*X*X*X*X***X*****X*X*****X*X*****X*X
XX*XXXXXXXXX*XXX*XXX*X*XXX*XXX*XXXXXXXXX*X*X*X*XXXXXXXXXXX*X*XXXXX*X*XXXXXXXXX*X*XXXXX*X*XXXXX*X*X*X
***X*********X***X***X*X***X***X*********X*X*X*X***********X*X*****X*X*********X*X*****X*X*****X*X**
XXXX*X*XXX*X*XXXXXXX*XXXXX*X*XXX*XXX*XXX*X*XXXXXXXXXXX*X*XXXXX*XXX*XXXXX*X*XXX*X*XXX*X*X*X*XXXXX*X*X
*****X*X***X*X*******X*****X*X***X***X***X*X***********X*X*****X***X*****X*X***X*X***X*X*X*X*****X*X
XXXXXXXXXXXXXXXX*XXXXX*X*X*X*XXX*XXX*XXX*X*XXXXXXX*X*XXX*XXX*X*XXX*X*XXX*X*XXXXX*X*XXX*XXX*X*X*X*X*X
*****************X*****X*X*X*X***X***X***X*X*******X*X***X***X*X***X*X***X*X*****X*X***X***X*X*X*X**
XX*X*XXXXXXXXXXX*XXXXXXX*X*X*X*X*X*XXX*XXX*X*X*X*XXXXXXX*X*XXX*XXX*XXXXXXXXX*X*XXX*XXX*XXX*X*X*XXX*X
***X*X***********X*******X*X*X*X*X*X***X***X*X*X*X*******X*X***X***X*********X*X***X***X***X*X*X***X
*X*XXXXXXX*X*X*X*XXXXX*XXXXX*XXX*X*XXXXXXXXX*XXXXX*XXX*X*XXXXXXX*XXXXXXX*X*X*XXXXX*XXXXX*X*XXXXXX*XX
*X*X*******X*X*X*X*****X*****X***X*X*********X*****X***X*X*******X*******X*X*X*****X*****X*X********
XXXX*X*XXX*X*X*XXX*X*XXX*X*XXX*XXXXXXX*XXX*X*XXXXXXXXX*XXXXX*XXXXX*X*X*XXXXXXXXXXXXXXX*X*XXXXX*XXXXX
*****X*X***X*X*X***X*X***X*X***X*******X***X*X*********X*****X*****X*X*X***************X*X**********
XX*XXXXX*XXXXXXXXXXXXXXX*X*XXXXX*XXXXX*XXXXX*X*XXX*X*XXXXX*X*XXXXX*X*XXX*X*XXX*XXXXX*X*X*X*X*XXXXX*X
***X*****X***************X*X*****X*****X*****X*X***X*X*****X*X*****X*X***X*X***X*****X*X*X*X*X*****X
*XXXXXXXXXXXXX*XXXXX*X*XXX*XXX*X*X*X*XXXXX*XXX*XXXXX*X*XXX*XXXXX*XXXXX*XXXXX*XXXXXXX*X*X*X*XXX*XXX*X
*X*************X*****X*X***X***X*X*X*X*****X***X*****X*X***X*****X*****X*****X*******X*X*X*X***X***X
*XXXXX*XXXXX*X*X*XXXXXXXXX*XXXXX*X*X*XXX*X*XXX*XXX*XXX*XXX*XXX*X*X*X*X*X*XXXXX*XXXXX*XXXXX*X*X*X*XXX
*X*****X*****X*X*X*********X*****X*X*X***X*X***X***X***X***X***X*X*X*X*X*X*****X*****X*****X*X*X****
XX*X*X*XXXXX*X*X*XXX*XXXXXXX*X*XXXXXXX*XXXXXXX*XXX*XXX*XXXXXXXXX*X*X*X*XXXXXXX*X*XXX*X*XXX*XXXXX*X*X
***X*X*X*****X*X*X***X*******X*X*******X*******X***X***X*********X*X*X*X*******X*X***X*X***X*****X**
*X*X*XXX*X*XXX*X*XXX*X*XXX*XXX*X*XXXXXXX*XXX*XXXXXXX*X*X*X*XXX*XXXXX*XXX*XXX*XXXXXXX*XXX*X*XXXXX*XX*
*X*X*X***X*X***X*X***X*X***X***X*X*******X***X*******X*X*X*X***X*****X***X***X*******X***X*X*****X**
*XXXXX*XXXXXXX*XXXXXXX*XXXXXXXXX*XXX*X*X*XXXXX*X*X*X*XXXXX*XXX*X*XXX*XXX*X*X*X*X*X*XXXXX*XXXXXXX*X*X
*X*****X*******X*******X*********X***X*X*X*****X*X*X*X*****X***X*X***X***X*X*X*X*X*X*****X*******X**
XXXX*X*X*XXX*X*X*XXXXXXXXXXX*XXX*X*X*XXXXX*XXXXXXX*X*X*XXX*XXXXX*XXX*XXXXXXXXX*X*XXXXX*XXX*X*XXXXXX*
*****X*X*X***X*X*X***********X***X*X*X*****X*******X*X*X***X*****X***X*********X*X*****X***X*X******
*X*X*X*XXXXXXX*XXX*X*XXXXX*X*X*XXXXX*X*X*X*X*XXX*X*X*X*X*X*XXXXX*X*XXX*X*XXXXX*XXX*X*XXX*XXX*X*XXXX*
*X*X*X*X*******X***X*X*****X*X*X*****X*X*X*X*X***X*X*X*X*X*X*****X*X***X*X*****X***X*X***X***X*X****
*X*XXX*X*X*XXXXXXXXXXX*X*X*X*XXXXX*XXX*X*X*XXXXXXX*X*X*X*XXXXX*X*XXXXXXX*X*X*X*X*X*XXXXX*X*XXX*X*X*X
*X*X***X*X*X***********X*X*X*X*****X***X*X*X*******X*X*X*X*****X*X*******X*X*X*X*X*X*****X*X***X*X**
XX*X*XXXXXXXXX*XXXXX*X*X*X*X*XXXXXXX*XXX*XXXXX*X*XXX*X*X*X*XXX*X*X*XXX*XXXXXXXXXXXXX*X*X*XXX*XXX*XX*
***X*X*********X*****X*X*X*X*X*******X***X*****X*X***X*X*X*X***X*X*X***X*************X*X*X***X***X**
XX*XXXXXXXXX*X*X*X*X*X*XXX*X*X*X*X*X*X*X*X*XXXXX*XXXXX*X*XXX*XXX*X*XXXXXXX*X*X*XXX*XXXXXXX*X*X*XXX*X
***X*********X*X*X*X*X*X***X*X*X*X*X*X*X*X*X*****X*****X*X***X***X*X*******X*X*X***X*******X*X*X***X
XX*XXXXXXX*XXXXXXXXXXX*XXXXX*XXXXX*X*X*XXXXXXX*XXXXXXXXX*X*X*X*XXX*X*XXX*XXXXX*XXX*X*XXX*XXXXX*X*X*X
***X*******X***********X*****X*****X*X*X*******X*********X*X*X*X***X*X***X*****X***X*X***X*****X*X*X
XX*X*X*XXXXX*X*XXX*XXX*XXXXXXXXX*X*XXX*X*XXXXXXXXX*XXXXXXX*X*X*XXX*XXX*X*X*XXX*XXXXXXX*XXXXX*X*XXX*X
***X*X*X*****X*X***X***X*********X*X***X*X*********X*******X*X*X***X***X*X*X***X*******X*****X*X***X
*X*X*X*X*X*X*X*X*X*XXXXXXXXX*XXX*XXXXX*X*XXX*X*X*XXXXXXX*XXX*XXX*XXXXXXX*X*X*XXXXX*X*X*X*XXX*X*X*X*X
*X*X*X*X*X*X*X*X*X*X*********X***X*****X*X***X*X*X*******X***X***X*******X*X*X*****X*X*X*X***X*X*X*X
XXXXXXXXXX*XXXXXXX*XXX*XXX*XXXXX*X*X*XXXXX*X*X*XXXXX*XXX*XXX*XXX*X*XXX*X*XXX*X*X*X*XXX*XXXXX*X*XXX*X
***********X*******X***X***X*****X*X*X*****X*X*X*****X***X***X***X*X***X*X***X*X*X*X***X*****X*X****
XXXXXX*XXXXXXXXXXX*XXXXXXX*XXX*XXXXXXX*X*X*XXX*X*XXXXXXXXX*X*XXX*X*X*X*X*XXXXX*X*XXX*X*X*X*XXXXX*X*X
*******X***********X*******X***X*******X*X*X***X*X*********X*X***X*X*X*X*X*****X*X***X*X*X*X*****X**
*X*X*XXXXXXXXXXXXX*X*X*XXXXXXXXX*XXXXX*X*XXXXXXX*XXXXX*X*XXX*XXX*XXXXX*XXX*X*X*XXXXXXX*XXXXX*XXX*X*X
*X*X*X*************X*X*X*********X*****X*X*******X*****X*X***X***X*****X***X*X*X*******X*****X***X*X
*XXX*X*X*XXX*X*XXX*XXX*X*X*X*XXX*XXX*XXX*X*X*X*XXX*X*X*X*XXXXXXX*X*XXXXXXX*X*XXXXX*X*XXX*XXXXXXXXX*X
*X***X*X*X***X*X***X***X*X*X*X***X***X***X*X*X*X***X*X*X*X*******X*X*******X*X*****X*X***X*********X
XX*XXX*XXX*X*XXXXXXXXX*X*X*XXX*X*XXXXX*XXX*XXX*X*X*XXX*X*XXXXXXXXXXX*XXX*XXXXXXX*X*X*XXXXX*X*XXXXX*X
***X***X***X*X*********X*X*X***X*X*****X***X***X*X*X***X*X***********X***X*******X*X*X*****X*X*****X
*XXXXX*XXX*X*XXXXXXXXXXXXXXX*XXX*XXXXX*XXX*XXX*X*X*X*XXX*X*XXXXX*XXX*X*XXXXX*XXX*XXX*X*XXXXX*X*XXX*X
*X*****X***X*X***************X***X*****X***X***X*X*X*X***X*X*****X***X*X*****X***X***X*X*****X*X****
XXXXXXXXXXXXXXXXXXXXXXXXXXXXXXXXXXXXXXXXXXXXXXXXXXXXXXXXXXXXXXXXXXXXXXXXXXXXXXXXXXXXXXXXXXXXXXXXXXX*
